00000160100000001020100000#
00000100100000001000100000#
00000100100000001000100000#
00000100100000001000100000#
00000100100000001000100000#
11111100111111110000100000#
00000000000000000000011111#
30000000000000000000000007#
00000000000000000000000000#
00000000000000000000111111#
11111111100000111111000000#
00000000010001000000000000#
00000000010001000000000000#
00000000010001000000000000#
00000000010001000000000000#
00000000010501000000000000#
8