00000107010000001020100000#
00000100010000001000100000#
00000100010000001000100000#
00000100010000001000100000#
00000100010000001000100000#
11111100011111110000011111#
00000000000000000000000000#
30000000000000000000000006#
00000000000000000000000006#
00000000000000000000000000#
11111111100000111111111111#
00000000010001000000000000#
00000000010001000000000000#
00000000010001000000000000#
00000000010001000000000000#
00000000010501000000000000#
8