11111111111111111222111111#
10000000000000001000100001#
10000000000000001000100001#
10000000000000001000100001#
10000000000000001000100001#
11111111111111110000011111#
00000000000000000000000002#
00000000000000000000000002#
10000000000000000000000002#
10000000000000000000000002#
11111111100000111111111111#
10000000010001000000000001#
10000000010001000000000001#
10000000010001000000000001#
10000000010001000000000001#
11111111112221111111111111#
8