00070000010000001111111111#
00000000010000001000000000#
00000000010000001000000002#
11111000010000001000000000#
00000100010000001000111111#
11111000001111110000111111#
00000000000000000000000000#
30000000000000000000000006#
00000000000000000000000006#
00000000000000000000000000#
11111000100000111111111111#
00001000100001000000000000#
00001000011110000000000000#
00001000000000000000000050#
00001000000000000000000000#
000001111111111111111111110
8