00000000000000001020100000#
00000000000000001000100000#
00000000000000001000100000#
00000000000000001000100000#
00000000000000001000100000#
11111111111111110000011111#
00000000000000000000000000#
30000000000000000000000002#
00000000000000000000000002#
00000000000000000000000000#
11111111100000111111111111#
00000000010001000000000000#
00000000010001000000000000#
00000000010001000000000000#
00000000010001000000000000#
00000000010501000000000000#
8