00000000170101061000000000#
11111111000010000110000000#
00000000000000000001000000#
50000000000000000001000000#
11100001111111111110000000#
00100001000000000000000000#
00100001000000000000000000#
11100001111111111111000000#
00000000000000000000100000#
30000000000000000000100000#
00000000000000000000100000#
11111111111111110000100000#
00000000000000001000100000#
00000000000000001000100000#
00000000000000001000100000#
00000000000000001020100000#
8

